MMMMMMMMMMMMMMMMMMMM
MSSSSSSSSSSSSSSSSSSM
MSSWSSSSSSSSSSSSSSSM
MGGWWWGGGGGGGGGGGGGM
MGGWWWWGGGGGGGGGGGGM
MGGGGGGGGGGGGGGGGGGM
MGGGGGGGGGGGGGGGGGGM
MGGGGGGGGGGGGGGGGGGM
MGGGGGGGGGGGGGGGGGGM
MGGGGGGGGGGGGGGGGGGM
MGGGGGGGGGGGGGGGGGGM
MGGGGGGGGGGGGGGGGGGM
MGGGGGGGGGGWWWWGGGGM
MGGWGGGGGGGGWWWWGGGM
MGGGWGGGGGGGGGGGGGGM
MGGGGGGGGGGGGGGGGGGM
MGGGGGGGGGGGGGGGGGGM
MSSSSSSSSSSSSSSSSSSM
MSSSSSSSSSSSSSSSSSSM
MMMMMMMMMMMMMMMMMMMM
